%%%%%%%%%%
%        %
%        %
%        %
%   WB   %
%   BW   %
%        %
%        %
%        %
%%%%%%%%%%
