%%%%%%%%%%
%       B%
%      B %
%     B  %
%   WB   %
%   BW   %
%  B     %
% B      %
%B       %
%%%%%%%%%%
