%%%%%%%%%%
%        %
% B    W %
%  B  W  %
%   WB   %
%   BW   %
%        %
%        %
%        %
%%%%%%%%%%
