%%%%%%%%%%
%        %
%        %
%   WWWWW%
%  WWBBBW%
%  WBBWWW%
% WWWWW  %
%  WBWW  %
%  WWWWW %
%%%%%%%%%%
