%%%%%%%%%%
%W       %
% W      %
%  W     %
%   WB   %
%   BW   %
%     W  %
%      W %
%       W%
%%%%%%%%%%
